1111111111111
10C100000PEC1
1111111111111