11111111111111111111111111111111111111111111111111111111111111111111111111111111111111111111111111111111111111111111111111111111
10000000000000000000000000000000000000000000000000000000000000000000000000000000000000000000000000000000000000000000000000C00001
10000000000000000000000000000000000000000000000000000000000000000000000000000000000000000000000000000000000000000000000000C00001
10000000000000000000000000000000000000000000000000000000000000000000000000000000000000000000000000000000000000000000000000C00001
10000000000000000000000000000000000000000000000000000000000000000000000000000000000000000000000000000000000000000000000000C00001
10000000000000000000000000000000000000000000000000000000000000000000000000000000000000000000000000000000000000000000000000C00001
10000000000000000000000000000000000000000000000000000000000000000000000000000000000000000000000000000000000000000000000000C00001
10000000000000000000000000000000000000000000000000000000000000000000000000000000000000000000000000000000000000000000000000C00001
10000000000000000000000000000000000000000000000000000000000000000000000000000000000000000000000000000000000000000000000000C00001
10000000000000000000000000000000000000000000000000000000000000000000000000000000000000000000000000000000000000000000000000C00001
10000000000000000000000000000000000000000000000000000000000000000000000000000000000000000000000000000000000000000000000000C00001
10000000000000000000000000000000000000000000000000000000000000000000000000000000000000000000000000000000000000000000000000C00001
10000000000000000000000000000000000000000000000000000000000000000000000000000000000000000000000000000000000000000000000000C00001
10000000000000000000000000000000000000000000000000000000000000000000000000000000000000000000000000000000000000000000000000C00001
10000000000000000000000000000000000000000000000000000000000000000000000000000000000000000000000000000000000000000000000000C00001
10000000000000000000000000000000000000000000000000000000000000000000000000000000000000000000000000000000000000000000000000C00001
10000000000000000000000000000000000000000000000000000000000000000000000000000000000000000000000000000000000000000000000000C00001
10000000000000000000000000000000000000000000000000000000000000000000000000000000000000000000000000000000000000000000000000C00001
10000000000000000000000000000000000000000000000000000000000000000000000000000000000000000000000000000000000000000000000000C00001
10000000000000000000000000000000000000000000000000000000000000000000000000000000000000000000000000000000000000000000000000C00001
10000000000000000000000000000000000000000000000000000000000000000000000000000000000000000000000000000000000000000000000000C00001
10000000000000000000000000000000000000000000000000000000000000000000000000000000000000000000000000000000000000000000000000C00001
10000000000000000000000000000000000000000000000000000000000000000000000000000000000000000000000000000000000000000000000000C00001
10000000000000000000000000000000000000000000000000000000000000000000000000000000000000000000000000000000000000000000000000C00001
10000000000000000000000000000000000000000000000000000000000000000000000000000000000000000000000000000000000000000000000000C00001
10000000000000000000000000000000000000000000000000000000000000000000000000000000000000000000000000000000000000000000000000C00001
10000000000000000000000000000000000000000000000000000000000000000000000000000000000000000000000000000000000000000000000000C00001
10000000000000000000000000000000000000000000000000000000000000000000000000000000000000000000000000000000000000000000000000C00001
10000000000000000000000000000000000000000000000000000000000000000000000000000000000000000000000000000000000000000000000000C00001
10000000000000000000000000000000000000000000000000000000000000000000000000000000000000000000000000000000000000000000000000C00001
10000000000000000000000000000000000000000000000000000000000000000000000000000000000000000000000000000000000000000000000000C00001
10000000000000000000000000000000000000000000000000000000000000000000000000000000000000000000000000000000000000000000000000C00001
10000000000000000000000000000000000000000000000000000000000000000000000000000000000000000000000000000000000000000000000000C00001
10000000000000000000000000000000000000000000000000000000000000000000000000000000000000000000000000000000000000000000000000C00001
10000000000000000000000000000000000000000000000000000000000000000000000000000000000000000000000000000000000000000000000000C00001
10000000000000000000000000000000000000000000000000000000000000000000000000000000000000000000000000000000000000000000000000C00001
10000000000000000000000000000000000000000000000000000000000000000000000000000000000000000000000000000000000000000000000000C00001
10000000000000000000000000000000000000000000000000000000000000000000000000000000000000000000000000000000000000000000000000C00001
10000000000000000000000000000000000000000000000000000000000000000000000000000000000000000000000000000000000000000000000000C00001
10000000000000000000000000000000000000000000000000000000000000000000000000000000000000000000000000000000000000000000000000C00001
10000000000000000000000000000000000000000000000000000000000000000000000000000000000000000000000000000000000000000000000000C00001
10000000000000000000000000000000000000000000000000000000000000000000000000000000000000000000000000000000000000000000000000C00001
10000000000000000000000000000000000000000000000000000000000000000000000000000000000000000000000000000000000000000000000000C00001
10000000000000000000000000000000000000000000000000000000000000000000000000000000000000000000000000000000000000000000000000C00001
10000000000000000000000000000000000000000000000000000000000000000000000000000000000000000000000000000000000000000000000000C00001
10000000000000000000000000000000000000000000000000000000000000000000000000000000000000000000000000000000000000000000000000C00001
10000000000000000000000000000000000000000000000000000000000000000000000000000000000000000000000000000000000000000000000000C00001
10000000000000000000000000000000000000000000000000000000000000000000000000000000000000000000000000000000000000000000000000C00001
10000000000000000000000000000000000000000000000000000000000000000000000000000000000000000000000000000000000000000000000000C00001
10000000000000000000000000000000000000000000000000000000000000000000000000000000000000000000000000000000000000000000000000C00001
10000000000000000000000000000000000000000000000000000000000000000000000000000000000000000000000000000000000000000000000000C00001
10000000000000000000000000000000000000000000000000000000000000000000000000000000000000000000000000000000000000000000000000C00001
10000000000000000000000000000000000000000000000000000000000000000000000000000000000000000000000000000000000000000000000000C00001
10000000000000000000000000000000000000000000000000000000000000000000000000000000000000000000000000000000000000000000000000C00001
10000000000000000000000000000000000000000000000000000000000000000000000000000000000000000000000000000000000000000000000000C00001
10000000000000000000000000000000000000000000000000000000000000000000000000000000000000000000000000000000000000000000000000C00001
10000000000000000000000000000000000000000000000000000000000000000000000000000000000000000000000000000000000000000000000000C00001
10000000000000000000000000000000000000000000000000000000000000000000000000000000000000000000000000000000000000000000000000C00001
10000000000000000000000000000000000000000000000000000000000000000000000000000000000000000000000000000000000000000000000000C00001
10000000000000000000000000000000000000000000000000000000000000000000000000000000000000000000000000000000000000000000000000C00001
10000000000000000000000000000000000000000000000000000000000000000000000000000000000000000000000000000000000000000000000000C00001
10000000000000000000000000000000000000000000000000000000000000000000000000000000000000000000000000000000000000000000000000C00001
10000000000000000000000000000000000000000000000000000000000000000000000000000000000000000000000000000000000000000000000000C00001
10000000000000000000000000000000000000000000000000000000000000000000000000000000000000000000000000000000000000000000000000C00001
10000000000000000000000000000000000000000000000000000000000000000000000000000000000000000000000000000000000000000000000000C00001
10000000000000000000000000000000000000000000000000000000000000000000000000000000000000000000000000000000000000000000000000C00001
10000000000000000000000000000000000000000000000000000000000000000000000000000000000000000000000000000000000000000000000000C00001
10000000000000000000000000000000000000000000000000000000000000000000000000000000000000000000000000000000000000000000000000C00001
10000000000000000000000000000000000000000000000000000000000000000000000000000000000000000000000000000000000000000000000000C00001
10000000000000000000000000000000000000000000000000000000000000000000000000000000000000000000000000000000000000000000000000C00001
10000000000000000000000000000000000000000000000000000000000000000000000000000000000000000000000000000000000000000000000000C00001
10000000000000000000000000000000000000000000000000000000000000000000000000000000000000000000000000000000000000000000000000C00001
10000000000000000000000000000000000000000000000000000000000000000000000000000000000000000000000000000000000000000000000000C00001
10000000000000000000000000000000000000000000000000000000000000000000000000000000000000000000000000000000000000000000000000C00001
10000000000000000000000000000000000000000000000000000000000000000000000000000000000000000000000000000000000000000000000000C00001
10P00000000000000000000000000000000000000000000000000000000000000000000000000000000000000000000000000000000000000000000000C000E1
11111111111111111111111111111111111111111111111111111111111111111111111111111111111111111111111111111111111111111111111111111111