1111111111111
10C100000PEC1
1001000000001
1111111111111