1111111111111
1C11000000P11
1000011111111
100E111000001
1111111111111