1111111111111
10C1000000EC1
1000000000001
1111111111111