1111111111111
10C000000PEC1
1111111111111