1111111111111
10C1000000PC1
1000011110001
100011E000001
1111111111111