1111111111111
101100000P001
10000E0000001
1111111111111