1111111111111
10C100000P0C1
1000000000001
1111111111111